NO textures/simonkraft/soul_sand.xpm
SO textures/simonkraft/soul_soil_01.xpm
WE textures/simonkraft/soul_soil.xpm
EA textures/simonkraft/soul_sand.xpm

C 53,41,34
F 45,33,27

          1111 11111111111 111
          10011100000000011101
          10000000011111111111
11111111110111111111          
   1001N000111111111          
11111111111111111111          